1,7580,9380,113,0,113,
2,10460,12260,66,53,119,5:53
3,11900,13700,30,0,30,
4,8100,9900,123,0,123,
5,9020,10820,0,0,0,
6,8955,10755,90,0,90,
7,11835,13635,145,16,161,1290:16
8,7515,9315,153,0,153,
9,7325,9125,101,0,101,
10,8765,10565,100,0,100,
11,10205,12005,0,0,0,
12,11645,13445,74,3,77,11:3
13,7325,9125,147,0,147,
14,8765,10565,133,0,133,
15,7290,9090,135,0,135,
16,8730,10530,131,0,131,
17,10170,11970,0,0,0,
18,11610,13410,101,27,128,17:27
19,7605,10125,139,0,139,
20,10635,12215,110,53,163,1156:53
21,12075,12435,92,3,95,25:3
22,10470,12270,121,0,121,
23,10635,12435,110,73,183,707:53&2268:20
24,7755,9555,145,0,145,
25,9195,10995,0,0,0,
26,7825,9625,142,0,142,
27,9265,11065,92,0,92,
28,10705,12505,108,75,183,17:75
29,12145,13945,93,0,93,
30,10995,12535,85,34,119,1265:32&1290:2
31,11910,13710,118,0,118,
32,12075,13405,120,63,183,124:63
33,10945,12220,84,99,183,57:99
34,7490,9290,119,0,119,
35,8930,10730,126,0,126,
36,10370,12170,0,0,0,
37,11810,13390,76,85,161,1248:57&36:28
38,12435,14235,64,0,64,
39,9505,11305,0,0,0,
40,8065,9865,124,0,124,
41,12385,12745,66,59,125,39:59
42,7275,9075,161,0,155,
43,8715,10515,151,0,151,
44,10155,11955,0,0,0,
45,11595,13395,126,57,183,678:57
46,7590,9390,145,0,145,
47,7755,9555,160,0,155,
48,9030,10830,81,0,81,
49,7710,9510,119,0,119,
50,9150,10950,0,0,0,
51,10590,12390,106,77,183,141:77
52,12030,12390,63,98,161,1249:14&50:74&141:10
53,9195,10995,0,0,0,
54,10420,12220,116,67,183,39:61&57:6
55,7515,9315,124,0,124,
56,7540,9340,141,0,141,
57,8980,10780,0,0,0,
58,11860,12220,83,78,161,57:78
59,8955,10755,125,0,125,
60,10395,12195,0,0,0,
61,11835,13415,111,52,163,1194:35&60:17
62,7450,9250,125,0,125,
63,8890,10690,134,0,134,
64,10330,12130,91,0,91,
65,11770,13570,126,0,126,
66,7410,9930,95,0,95,
67,10820,12620,63,56,119,1276:56
68,12260,14060,46,0,46,
69,8545,11065,213,0,213,
70,7795,9595,119,0,119,
71,10675,12475,43,76,119,11:76
72,12115,13915,54,0,54,
73,9505,12025,88,0,88,
74,8710,10510,99,0,99,
75,11590,13390,66,53,119,2269:53
76,8105,9905,121,0,121,
77,9545,11345,0,0,0,
78,10985,12430,81,80,161,1650:80
79,12425,14225,44,0,44,
80,8935,10735,111,0,111,
81,11815,13615,98,0,98,
82,10955,12640,76,85,161,1636:32&922:53
83,8055,9855,119,0,119,
84,10935,12260,73,44,117,5:44
85,12375,14175,47,0,47,
86,7370,9170,99,0,99,
87,8810,10610,123,0,123,
88,10250,12050,0,0,0,
89,11690,13490,74,45,119,88:45
90,7270,9070,123,0,119,
91,7495,9295,118,0,118,
92,7545,9345,122,0,122,
93,11865,12420,128,33,161,113:25&1676:8
94,7710,9510,125,0,119,
95,10590,12390,85,0,85,
96,7915,9715,87,0,87,
97,10795,12595,81,38,119,1676:38
98,8985,10785,0,0,0,
99,10425,12225,101,60,161,98:60
100,7555,9355,111,0,111,
101,8995,10795,0,0,0,
102,10435,12235,94,67,161,101:67
103,11875,12235,63,21,84,101:21
104,9130,11650,0,0,0,
105,12010,14530,99,0,99,
106,8840,11360,108,0,108,
107,11720,12470,117,44,161,1475:7&985:37
108,9335,11710,98,63,161,848:63
109,12070,14590,100,0,100,
110,9330,11850,0,0,0,
111,12210,14730,51,0,51,
112,7740,9540,119,0,119,
113,9180,10980,0,0,0,
114,10375,12175,111,50,161,980:50
115,11670,13470,130,0,130,
116,7400,9200,74,0,74,
117,10530,12080,40,108,148,192:51&240:57
118,11720,13520,75,0,75,
119,11815,13615,126,0,126,
120,7350,9150,141,0,141,
121,7495,9295,161,0,161,
122,7285,9085,161,0,161,
123,8725,10525,177,0,177,
124,10165,11965,0,0,0,
125,11605,12805,124,59,183,2268:59
126,7665,9465,110,0,110,
127,9105,10905,0,0,0,
128,10545,12345,96,23,119,1248:14&127:9
129,11985,13610,65,54,119,36:54
130,8675,10475,168,0,168,
131,10115,11915,137,46,183,25:46
132,7235,9035,173,0,173,
133,11555,12215,153,30,183,1156:30
134,10755,12390,71,48,119,50:48
135,7505,9305,125,0,125,
136,8945,10745,0,0,0,
137,10385,12185,71,112,183,1650:2&136:110
138,11825,12785,92,27,119,77:27
139,8840,10640,66,0,66,
140,7875,9675,113,0,113,
141,9315,11115,0,0,0,
142,12195,12595,51,68,119,1249:68
143,10995,12795,113,0,113,
144,7960,9760,149,0,149,
145,12280,14080,79,0,79,
146,7260,9060,142,0,142,
147,8700,10500,91,0,91,
148,10140,11940,0,0,0,
149,11580,13380,76,0,76,
150,8115,9915,146,0,146,
151,12435,14235,59,0,59,
152,10620,12420,84,99,183,2259:40&1676:59
153,12060,12420,78,19,97,113:19
154,8070,9870,146,0,146,
155,9510,11310,0,0,0,
156,10950,12750,113,70,183,1194:70
157,12390,13635,98,85,183,60:85
158,10230,12030,81,0,81,
159,9550,12070,0,0,0,
160,8060,9860,118,0,118,
161,8095,9895,85,0,85,
162,9535,11335,0,0,0,
163,10985,12785,52,65,117,1297:65
164,12415,14215,28,0,28,
165,7305,9105,98,0,98,
166,8745,10545,95,0,95,
167,10185,11985,0,0,0,
168,11625,13425,112,49,161,548:49
169,7545,10065,113,0,113,
170,8985,11505,116,0,116,
171,10425,12945,0,0,0,
172,11865,13665,51,67,118,171:67
173,7590,9390,103,0,103,
174,9235,10830,70,57,127,1296:57
175,10470,12270,0,0,0,
176,11910,13710,98,0,98,
177,8160,9960,176,0,176,
178,9600,11400,0,0,0,
179,11040,12840,138,45,183,178:12&44:33
180,12480,12840,113,67,180,178:67
181,7290,9090,55,0,55,
182,11610,13410,78,0,78,
183,7490,9290,145,0,145,
184,8930,10730,126,0,126,
185,10370,12170,100,61,161,1283:61
186,11810,12300,133,8,141,470:8
187,9320,11120,0,0,0,
188,10760,12560,49,0,49,
189,7880,9680,105,0,105,
190,12200,14000,34,0,34,
191,8730,10530,49,0,49,
192,10170,11970,0,0,0,
193,7890,9690,112,0,112,
194,10830,12570,54,107,161,148:76&175:31
195,7780,10300,128,0,128,
196,10660,12460,145,16,161,216:16
197,12100,13495,104,79,183,268:79
198,7710,9510,157,0,157,
199,9150,10950,62,0,62,
200,10830,12390,45,116,161,1297:1&231:88&175:27
201,12030,13830,49,0,49,
202,7375,9175,128,0,128,
203,8815,10615,72,0,72,
204,10255,12055,0,0,0,
205,11695,13495,95,0,95,
206,8110,10630,104,0,104,
207,10990,13450,129,32,161,766:32
208,12430,14950,69,0,69,
209,10940,12740,78,0,78,
210,7355,9875,96,0,96,
211,8795,11315,103,0,103,
212,10235,12370,67,116,183,851:49&104:67
213,11675,14195,105,0,105,
214,7540,9340,88,0,88,
215,10530,12220,67,96,163,192:30&273:37&187:29
216,9220,11740,0,0,0,
217,8980,10780,52,0,52,
218,11860,13660,49,0,49,
219,12065,13865,46,0,46,
220,7695,10215,74,0,74,
221,10610,13095,67,94,161,567:94
222,10860,12660,56,0,56,
223,7980,9780,89,0,89,
224,7745,9545,155,0,155,
225,9185,10985,0,0,0,
226,7950,9750,122,0,122,
227,10830,12630,43,118,161,257:44&260:38&1268:36
228,12270,14070,34,0,34,
229,10580,12580,138,23,161,1062:23
230,7980,9780,94,0,94,
231,9420,11220,0,0,0,
232,10860,12660,63,56,119,1297:29&162:27
233,12300,14100,60,0,60,
234,10290,12810,0,0,0,
235,10985,12785,55,0,55,
236,12425,14225,43,0,43,
237,7670,10190,154,0,154,
238,9140,11660,0,0,0,
239,12020,12580,146,37,183,1062:37
240,9585,11385,0,0,0,
241,7740,9540,116,0,116,
242,9180,10980,86,0,86,
243,10620,12420,0,0,0,
244,12060,13425,74,87,161,243:15&548:28&167:44
245,7410,9930,69,0,69,
246,8850,11370,161,0,161,
247,11730,13710,141,42,183,1061:42
248,11025,12825,78,0,78,
249,8105,9905,117,0,117,
250,9545,11345,0,0,0,
251,7800,9600,125,0,125,
252,9240,11040,51,0,51,
253,10830,12480,67,94,161,1297:4&204:80&175:10
254,12120,13920,29,0,29,
255,8145,9945,79,0,79,
256,12465,14265,98,0,98,
257,9390,11190,0,0,0,
258,7535,9335,106,0,106,
259,8975,10775,53,0,53,
260,10415,12215,0,0,0,
261,11855,13655,95,0,95,
262,7685,10205,105,0,105,
263,10685,12365,84,99,183,1322:14&1338:85
264,7905,10425,88,0,88,
265,10785,12590,81,102,183,1347:58&171:44
266,12300,14100,42,0,42,
267,7375,9895,118,0,118,
268,10255,12775,0,0,0,
269,7760,9560,120,0,120,
270,9200,11000,0,0,0,
271,10640,12440,56,0,56,
272,12080,13880,39,0,39,
273,9420,11220,0,0,0,
274,10625,12425,68,93,161,225:66&1288:27
275,8085,10605,111,0,111,
276,9525,12045,0,0,0,
277,7500,9300,160,0,160,
278,8940,10740,131,0,131,
279,10380,12180,78,0,78,
280,11820,13620,130,0,130,
281,7310,9110,92,0,92,
282,8750,10550,71,0,71,
283,10190,11990,0,0,0,
284,11630,13430,120,63,183,283:19&446:44
285,7580,10100,86,0,86,
286,9020,11540,88,0,88,
287,10460,12765,84,91,175,276:91
288,11900,14420,66,0,66,
289,7380,9900,111,0,111,
290,8820,11340,116,0,116,
291,10260,12780,0,0,0,
292,11700,13500,84,99,183,291:99
293,7430,9950,151,0,151,
294,8870,11390,90,0,90,
295,10310,12830,94,0,94,
296,11750,14270,86,0,86,
297,11040,13560,177,0,177,
298,7770,10290,20,0,20,
299,12090,14610,31,0,31,
300,10455,12975,113,0,113,
301,7840,9640,165,0,161,
302,9280,11080,62,0,62,
303,12160,13960,87,0,87,
304,12245,14765,56,0,56,
305,7925,10445,26,0,26,
306,9590,12110,0,0,0,
307,7575,10095,83,0,83,
308,9015,11535,91,0,91,
309,11895,14415,67,0,67,
310,8000,9800,153,0,153,
311,9440,11240,0,0,0,
312,7950,10470,140,0,140,
313,9390,11910,0,0,0,
314,10830,13350,88,0,88,
315,12270,14790,63,0,63,
316,10275,12795,0,0,0,
317,12320,12680,65,56,121,324:18&311:38
318,7325,9125,107,0,107,
319,8765,10565,128,0,128,
320,10205,12005,0,0,0,
321,11645,13445,88,0,88,
322,10720,12520,147,0,147,
323,12405,14925,82,0,82,
324,10880,12680,179,0,161,
325,7440,9960,134,0,134,
326,8880,11400,133,0,133,
327,10320,12630,97,86,183,313:86
328,11760,14280,114,0,114,
329,8035,10555,84,0,84,
330,9475,11995,0,0,0,
331,10915,12715,106,69,175,330:69
332,12355,14875,107,0,107,
333,10965,13485,125,0,125,
334,7570,9370,81,0,81,
335,9010,10810,104,0,104,
336,10450,12250,0,0,0,
337,11890,13410,126,57,183,336:39&2117:18
338,7505,9305,162,0,161,
339,8945,10745,140,0,140,
340,11825,13625,141,0,141,
341,9595,11395,81,0,81,
342,12475,14275,52,0,52,
343,9580,12100,0,0,0,
344,12460,12820,212,1,213,343:1
345,7750,9550,128,0,128,
346,10205,12005,0,0,0,
347,7955,9755,63,0,63,
348,10835,12635,118,43,161,2117:3&394:40
349,7925,9725,112,0,112,
350,10805,12605,82,0,82,
351,10630,12430,0,0,0,
352,12070,13870,96,38,134,351:38
353,10385,12185,112,0,112,
354,8100,9900,118,0,118,
355,10980,12485,105,44,149,376:21&2110:23
356,10810,12610,88,0,88,
357,8155,9955,151,0,151,
358,11035,12835,108,0,108,
359,11000,12800,93,0,93,
360,10510,12310,50,0,50,
361,10625,12425,0,0,0,
362,12245,14045,85,0,85,
363,7930,9730,136,0,136,
364,12250,14050,128,0,128,
365,7630,9430,132,0,132,
366,11950,13750,94,0,94,
367,8805,10605,127,0,127,
368,8930,10730,112,0,112,
369,12420,14220,38,0,38,
370,11875,13675,101,0,101,
371,7745,9545,167,0,161,
372,12065,12425,89,72,161,388:25&361:47
373,7555,9355,95,0,95,
374,10245,12045,143,0,143,
375,9365,11165,72,0,72,
376,9540,11340,0,0,0,
377,10435,12235,70,77,147,464:18&382:59
378,10370,12170,147,14,161,2110:14
379,7580,9380,130,0,130,
380,10460,12260,0,0,0,
381,11900,13700,103,22,125,380:22
382,8995,10795,0,0,0,
383,7365,9165,162,0,155,
384,11685,13485,132,0,132,
385,11720,14240,183,0,183,
386,7400,9920,178,0,178,
387,9070,10870,80,0,80,
388,9185,10985,0,0,0,
389,7490,9290,112,0,112,
390,11810,13610,130,0,130,
391,7325,9125,113,0,113,
392,8765,10565,153,0,153,
393,11645,13445,100,61,161,1536:55&346:6
394,9395,11195,0,0,0,
395,12275,13410,52,6,58,2117:6
396,7765,9565,103,0,103,
397,9205,11005,151,0,151,
398,10645,12445,83,0,83,
399,12085,13885,96,0,96,
400,9080,10880,53,0,53,
401,9295,11095,0,0,0,
402,8190,9990,165,0,161,
403,9630,11430,0,0,0,
404,11070,12535,77,84,161,401:79&1032:5
405,12510,14310,68,0,68,
406,7310,9110,115,0,115,
407,8750,10550,109,0,109,
408,10190,11990,0,0,0,
409,11630,13430,63,98,161,408:22&412:26&956:50
410,7605,9405,110,0,110,
411,9045,10845,70,0,70,
412,10485,12285,0,0,0,
413,11925,13430,120,15,135,408:15
414,7455,9255,122,0,122,
415,8895,10695,107,0,107,
416,10335,12135,91,0,91,
417,11775,13575,76,0,76,
418,10520,12320,126,0,126,
419,7750,9550,124,0,124,
420,9190,10990,95,0,95,
421,10630,12430,91,0,91,
422,12070,13870,123,0,123,
423,10735,12535,136,47,183,1032:47
424,10735,13255,0,0,0,
425,7640,9440,164,0,161,
426,11960,13760,88,0,88,
427,7855,10375,208,0,208,
428,7855,9655,164,0,161,
429,12175,12690,73,88,161,403:61&1032:27
430,7995,9795,148,0,148,
431,9435,11235,101,0,101,
432,10875,12675,107,0,107,
433,12315,14115,114,0,114,
434,8120,9920,161,0,161,
435,12440,14240,116,0,116,
436,7285,9085,107,0,107,
437,8725,10525,100,0,100,
438,10165,11965,0,0,0,
439,11605,13405,99,84,183,438:84
440,8020,9820,151,0,151,
441,9460,11260,128,0,128,
442,10900,12700,137,0,137,
443,12340,14140,90,0,90,
444,7565,9365,160,0,160,
445,9005,10805,157,0,157,
446,10445,12245,0,0,0,
447,11885,13430,115,46,161,283:46
448,7635,9435,100,0,100,
449,10515,12315,110,0,110,
450,7845,9645,122,0,122,
451,10725,12525,100,56,156,474:56
452,7780,9580,155,0,155,
453,9220,11020,84,0,84,
454,10660,12460,84,0,84,
455,12100,13900,87,0,87,
456,11955,13755,89,0,89,
457,7385,9185,153,0,153,
458,8825,10625,83,0,83,
459,10265,12065,141,0,141,
460,11705,13505,148,0,148,
461,11025,13545,174,0,174,
462,12165,13965,69,0,69,
463,7765,9565,168,0,168,
464,9205,11005,0,0,0,
465,10645,12445,132,0,132,
466,12085,13885,110,0,110,
467,7395,9915,167,0,167,
468,11715,14235,185,0,185,
469,7620,9420,167,0,161,
470,9060,10860,0,0,0,
471,10500,12300,131,30,161,1283:24&470:6
472,11940,13740,119,0,119,
473,9075,10875,41,0,41,
474,9285,11085,0,0,0,
475,7630,9430,157,0,157,
476,9070,10870,72,0,72,
477,10510,12310,0,0,0,
478,11950,13410,127,56,183,670:56
479,8050,9850,168,0,168,
480,9490,11290,0,0,0,
481,10930,12730,120,6,126,480:6
482,12370,14170,102,0,102,
483,7850,9650,117,0,117,
484,9290,11090,117,0,117,
485,10730,12530,129,32,161,167:32
486,12170,13860,79,26,105,243:26
487,7425,9225,121,0,121,
488,8865,10665,102,0,102,
489,10305,12105,0,0,0,
490,11745,13545,124,18,142,489:18
491,7415,9215,88,0,88,
492,8855,10655,105,0,105,
493,10295,12095,68,0,68,
494,11735,13535,105,0,105,
495,8130,9930,129,0,129,
496,9570,11370,0,0,0,
497,11010,12810,96,65,161,556:65
498,12450,14250,91,0,91,
499,9415,11215,0,0,0,
500,12295,14095,39,0,39,
501,9020,10820,122,0,122,
502,9000,10800,135,0,135,
503,10440,12240,0,0,0,
504,8170,9970,93,0,93,
505,12490,14290,81,0,81,
506,7780,9580,98,0,98,
507,10660,12460,30,0,30,
508,12100,13900,31,0,31,
509,7950,9750,95,0,95,
510,10830,12630,100,0,100,
511,12270,14070,33,0,33,
512,9180,10980,96,0,96,
513,10815,12615,111,0,111,
514,11050,12485,107,76,183,661:58&810:18
515,7560,9360,154,0,154,
516,11880,13680,255,0,255,
517,9375,11175,58,0,58,
518,9370,11170,0,0,0,
519,7245,9045,79,0,79,
520,8685,10485,72,0,72,
521,10125,11925,0,0,0,
522,11565,13365,33,0,33,
523,9610,11410,0,0,0,
524,9575,11375,0,0,0,
525,10700,12215,113,100,213,586:32&746:68
526,8940,10740,104,0,104,
527,10380,12180,0,0,0,
528,11820,13380,157,17,174,556:14&527:3
529,7820,9620,229,0,229,
530,12140,13940,36,0,36,
531,9485,11285,100,0,100,
532,10620,12420,77,86,163,742:86
533,9260,11060,0,0,0,
534,7655,9455,72,0,72,
535,11975,13775,36,0,36,
536,9180,10980,82,0,82,
537,12060,13860,115,0,115,
538,8290,10810,210,0,210,
539,11170,13690,207,0,207,
540,10690,12305,83,130,213,499:21&709:84&648:24&521:1
541,12130,13930,45,0,45,
542,7740,9540,166,0,166,
543,7620,9420,155,0,155,
544,7440,9240,39,0,39,
545,10320,12120,66,0,66,
546,7975,9775,143,0,143,
547,10855,12655,13,0,13,
548,10500,12300,0,0,0,
549,11940,13740,108,53,161,243:53
550,9250,11050,0,0,0,
551,7935,9735,146,0,146,
552,12255,14055,76,0,76,
553,8880,10680,91,0,91,
554,9565,11365,0,0,0,
555,10755,12555,91,0,91,
556,10140,11940,0,0,0,
557,10375,12175,102,111,213,550:53&648:58
558,7380,9180,183,0,183,
559,8820,10620,137,0,137,
560,10260,12060,0,0,0,
561,11700,13500,154,59,213,527:59
562,12195,13995,41,0,41,
563,7875,9675,59,0,59,
564,9315,11115,0,0,0,
565,11815,13615,87,0,87,
566,7370,9170,102,0,102,
567,10250,12050,0,0,0,
568,7495,9295,147,0,147,
569,8935,10735,71,0,71,
570,7290,9090,75,0,75,
571,8730,10530,99,0,99,
572,10170,11970,0,0,0,
573,11610,13410,98,65,163,503:62&735:3
574,11690,13490,118,7,125,567:7
575,10505,12305,127,58,185,521:58
576,11945,13745,90,0,90,
577,7800,9600,163,0,163,
578,9510,11040,52,33,85,732:33
579,10950,12480,111,144,255,730:18&715:58&572:21&735:47
580,12120,13920,125,0,125,
581,10955,12755,73,48,121,1322:48
582,8110,9910,149,0,149,
583,10990,12300,114,41,155,470:41
584,12430,14230,87,0,87,
585,7535,9335,163,0,163,
586,8975,10775,0,0,0,
587,10415,12215,143,112,255,753:37&533:75
588,11855,12350,141,22,163,753:22
589,8075,9875,125,0,125,
590,12300,14820,171,0,171,
591,9395,11915,185,0,185,
592,7635,9435,93,0,93,
593,9075,10875,111,0,111,
594,10515,12315,66,95,161,2081:95
595,11955,13755,134,0,134,
596,7260,9060,107,0,107,
597,8700,10500,132,0,132,
598,11580,13380,133,122,255,560:92&527:30
599,11005,12215,116,139,255,753:26&586:113
600,8125,9925,111,0,111,
601,12445,14245,36,0,36,
602,7675,9475,145,0,145,
603,10555,12355,145,0,145,
604,11995,13795,102,0,102,
605,8030,9830,155,0,155,
606,7545,9345,149,0,149,
607,7920,9720,143,0,143,
608,10425,12225,0,0,0,
609,11865,13430,133,50,183,608:10&2326:16&760:24
610,8810,11330,141,0,141,
611,10250,12770,0,0,0,
612,7970,9770,143,0,143,
613,9410,11210,91,0,91,
614,10850,12650,125,0,125,
615,12290,14090,53,0,53,
616,7695,9495,159,0,159,
617,10575,12375,78,0,78,
618,12015,13815,106,0,106,
619,7845,9645,130,0,130,
620,10725,12525,124,37,161,1307:37
621,12165,13965,124,0,124,
622,11050,12850,39,0,39,
623,8170,9970,102,0,102,
624,9610,11410,49,0,49,
625,12490,14290,34,0,34,
626,10745,12545,131,0,131,
627,7285,9085,119,0,119,
628,10165,11965,35,0,35,
629,11605,13405,90,0,90,
630,8020,9820,175,0,175,
631,9460,11260,121,0,121,
632,10900,12700,118,0,118,
633,12340,14140,64,0,64,
634,10910,12710,125,36,161,2336:36
635,9360,11160,72,0,72,
636,10800,12600,64,0,64,
637,12240,14040,66,0,66,
638,12185,13985,101,0,101,
639,7515,9315,143,0,143,
640,10395,12195,0,0,0,
641,11835,13635,95,0,95,
642,12350,12865,87,37,124,2336:37
643,7760,9560,213,0,213,
644,9200,11000,170,0,170,
645,10640,12440,123,0,123,
646,12080,13880,108,0,108,
647,7690,9490,206,0,206,
648,9065,10865,0,0,0,
649,7865,9665,144,0,144,
650,10835,12635,125,36,161,2268:36
651,7800,9600,113,0,113,
652,7955,9755,141,0,141,
653,10885,12685,109,74,183,659:74
654,7895,9695,166,0,161,
655,9335,11135,119,0,119,
656,10775,12575,131,52,183,1293:52
657,12215,13370,112,71,183,1293:71
658,8005,9805,161,0,161,
659,9445,11245,0,0,0,
660,7805,9605,174,0,163,
661,9245,11045,0,0,0,
662,10685,12485,163,0,119,
663,12125,12690,89,72,161,1479:37&810:35
664,7475,9275,71,0,71,
665,8915,10715,84,0,84,
666,10355,12155,0,0,0,
667,11795,13595,109,44,153,666:44
668,7290,9090,127,0,127,
669,8730,10530,108,0,108,
670,10170,11970,0,0,0,
671,11610,12790,82,79,161,1482:25&815:54
672,8040,9840,88,0,88,
673,9480,11280,69,0,69,
674,10920,12720,101,0,101,
675,12360,14160,74,0,74,
676,7420,9220,161,0,155,
677,8860,10660,128,0,128,
678,10300,12100,0,0,0,
679,11740,12840,116,67,183,178:67
680,8135,9935,133,0,133,
681,9575,11375,81,0,81,
682,11015,12815,45,0,45,
683,12455,14255,16,0,16,
684,7435,9235,107,0,107,
685,8875,10675,108,0,108,
686,10315,12115,59,0,59,
687,11755,13555,106,0,106,
688,9115,11635,0,0,0,
689,10555,12355,114,46,160,688:46
690,7610,9410,136,0,136,
691,9050,10850,87,0,87,
692,10490,12290,42,0,42,
693,11930,13730,125,0,125,
694,8690,10490,88,0,88,
695,10130,11930,40,0,40,
696,11570,13370,51,0,51,
697,9235,11035,91,0,91,
698,12120,13920,94,0,94,
699,7785,9585,154,0,154,
700,9225,11025,0,0,0,
701,10665,12465,89,94,183,700:94
702,7625,9425,148,0,148,
703,9065,10865,97,0,97,
704,10505,12305,150,0,119,
705,11945,13745,138,0,138,
706,10680,12480,120,0,120,
707,9395,11195,0,0,0,
708,12275,13405,116,67,183,124:67
709,9485,11285,0,0,0,
710,7345,9145,110,0,110,
711,8785,10585,115,0,115,
712,10225,12025,0,0,0,
713,11665,13465,84,99,183,712:99
714,8100,9900,116,0,116,
715,9540,11340,0,0,0,
716,10980,12780,108,53,161,572:53
717,12420,14220,80,0,80,
718,7555,9355,183,0,183,
719,8995,10795,167,0,167,
720,10435,12235,127,0,127,
721,11875,13675,84,0,84,
722,7545,9345,145,0,145,
723,10425,12225,113,70,183,731:70
724,11865,12225,120,60,180,731:60
725,8045,9845,91,0,91,
726,7240,9040,110,0,110,
727,8680,10480,147,0,147,
728,10120,11920,0,0,0,
729,11560,12350,54,129,183,753:54&554:75
730,10590,12390,0,0,0,
731,8985,10785,0,0,0,
732,9150,10950,0,0,0,
733,12030,13830,54,33,87,730:33
734,8880,10680,104,0,104,
735,10320,12120,0,0,0,
736,7710,9510,135,0,135,
737,10740,12540,94,119,213,496:84&742:32&556:3
738,12180,13980,68,0,68,
739,12295,14095,39,0,39,
740,7440,9240,155,0,155,
741,11760,13560,86,71,157,503:71
742,9300,11100,0,0,0,
743,10855,12350,58,105,163,753:105
744,7860,9660,123,0,123,
745,10550,12350,108,49,157,533:49
746,9415,11215,0,0,0,
747,7975,9775,120,0,120,
748,11990,12350,53,74,127,753:8&728:66
749,7350,9870,100,0,100,
750,11670,14190,66,0,66,
751,7670,9470,155,0,155,
752,10925,12725,97,0,97,
753,9110,10910,0,0,0,
754,12365,14165,62,0,62,
755,9085,10885,102,0,102,
756,9280,11080,0,0,0,
757,8120,10640,125,0,125,
758,12440,14960,66,0,66,
759,7310,9110,144,0,144,
760,10190,11990,0,0,0,
761,11630,13430,126,57,183,2326:57
762,11000,12800,107,54,161,763:54
763,9560,12080,0,0,0,
764,7330,9130,110,0,110,
765,8770,10570,139,0,139,
766,10210,12010,0,0,0,
767,11650,13450,108,28,136,849:28
768,7585,9385,96,0,96,
769,9025,10825,124,0,124,
770,7455,9255,168,0,168,
771,10335,12135,128,0,128,
772,11775,13575,146,0,146,
773,10465,12265,60,0,60,
774,11905,13705,122,0,122,
775,7830,9630,119,0,119,
776,9270,11070,0,0,0,
777,10710,12510,78,83,161,776:75&872:8
778,12150,13950,58,0,58,
779,8750,10550,144,0,144,
780,7520,9320,151,0,151,
781,8960,10760,154,0,154,
782,10400,12200,70,0,70,
783,11840,13640,78,0,78,
784,7795,9595,165,0,165,
785,10675,12475,141,0,141,
786,12115,13915,103,0,103,
787,8895,10695,114,0,114,
788,7355,9155,212,0,212,
789,8795,10595,180,0,180,
790,10235,12035,103,0,103,
791,10525,12325,132,0,132,
792,9495,11295,0,0,0,
793,10935,12270,90,29,119,875:29
794,11675,13475,89,0,89,
795,8010,9810,149,0,149,
796,10890,12690,146,37,183,523:37
797,12330,13445,87,10,97,1479:10
798,10720,12520,133,50,183,2336:50
799,8055,9855,118,0,118,
800,11965,13765,131,0,131,
801,12160,12520,89,72,161,2336:4&756:68
802,12375,12735,75,46,121,792:46
803,9235,11035,93,0,93,
804,7910,10430,109,0,109,
805,9350,11870,0,0,0,
806,10790,12590,100,61,161,2339:54&805:7
807,12230,14750,92,0,92,
808,7555,10075,117,0,117,
809,11875,12550,127,34,161,1450:34
810,9450,11250,0,0,0,
811,7645,9445,164,0,164,
812,7840,9640,183,0,183,
813,7430,9230,124,0,124,
814,8870,10670,129,0,129,
815,10310,12110,0,0,0,
816,11750,12790,88,95,183,1482:6&477:82&670:7
817,7915,9715,144,0,144,
818,10795,12595,82,0,82,
819,7545,9345,133,0,133,
820,8985,10785,157,0,157,
821,10425,12225,81,0,81,
822,11865,13665,118,0,118,
823,8085,9885,150,0,150,
824,10965,12765,94,0,94,
825,9355,11875,0,0,0,
826,7675,9475,86,0,86,
827,9115,10915,89,0,89,
828,10555,12355,67,0,67,
829,11995,13795,89,0,89,
830,12235,14035,80,0,80,
831,12405,14205,105,0,105,
832,10560,12360,106,0,106,
833,10730,12530,96,25,121,851:25
834,9100,10900,137,0,137,
835,10540,12340,159,0,159,
836,11980,13780,108,0,108,
837,7345,9865,81,0,81,
838,11665,13465,73,110,183,1447:110
839,7680,9480,169,0,169,
840,12000,13800,108,0,108,
841,7850,9650,146,0,146,
842,12170,13970,60,0,60,
843,9355,11155,82,0,82,
844,9230,11030,0,0,0,
845,10670,12470,154,29,183,895:29
846,12110,12795,129,32,161,895:32
847,7535,9335,91,0,91,
848,8975,10775,0,0,0,
849,10415,12215,0,0,0,
850,11855,13655,59,0,59,
851,9530,11330,0,0,0,
852,7475,9995,73,0,73,
853,11795,13595,101,16,117,1486:16
854,9120,10920,96,0,96,
855,9290,11090,0,0,0,
856,7660,9460,152,0,152,
857,7790,9590,171,0,161,
858,7735,9535,139,0,139,
859,9175,10975,110,0,110,
860,10615,12415,92,0,92,
861,12055,13855,87,0,87,
862,7505,9305,95,0,95,
863,8945,10745,73,0,73,
864,10385,12185,0,0,0,
865,11825,13625,95,37,132,1868:37
866,7355,9155,86,0,86,
867,7315,9115,143,0,143,
868,8755,10555,168,0,168,
869,10195,11995,0,0,0,
870,11635,13435,139,22,161,869:22
871,8795,10595,115,0,115,
872,10235,12035,0,0,0,
873,11675,13475,66,95,161,872:16&892:79
874,7590,9390,117,0,117,
875,9030,10830,0,0,0,
876,10470,12270,83,36,119,875:36
877,11910,12270,127,34,161,905:10&875:24
878,8090,9890,134,0,134,
879,7790,10310,93,0,93,
880,12110,13520,68,73,141,985:73
881,10970,12240,82,79,161,1817:33&1821:46
882,10510,12310,81,0,81,
883,10700,12500,121,40,161,980:24&1637:16
884,10995,12470,109,74,183,844:73&895:1
885,7255,9055,81,0,81,
886,10135,11935,0,0,0,
887,8115,9915,161,0,161,
888,12435,12795,107,76,183,895:76
889,11950,13750,95,0,95,
890,7460,9260,114,0,114,
891,8900,10700,123,0,123,
892,10340,12140,0,0,0,
893,11780,13475,88,30,118,872:30
894,12140,13940,56,0,56,
895,9555,11355,0,0,0,
896,7455,9255,170,0,170,
897,10335,12135,133,0,133,
898,7630,9430,147,0,147,
899,7860,9660,124,0,124,
900,9300,11100,59,0,59,
901,10740,12540,51,0,51,
902,12180,13980,53,0,53,
903,7820,9620,170,0,161,
904,7690,9490,132,0,132,
905,9130,10930,0,0,0,
906,10570,12270,101,82,183,792:58&875:24
907,12010,12370,73,88,161,905:88
908,7885,9685,153,0,153,
909,9325,11125,118,0,118,
910,10765,12565,127,56,183,869:56
911,12205,13435,134,6,140,869:6
912,7795,9595,176,0,176,
913,10675,12475,40,0,40,
914,8040,9840,155,0,155,
915,9480,11280,0,0,0,
916,10920,12720,83,78,161,2320:78
917,12360,14160,75,0,75,
918,7435,9235,151,0,151,
919,10315,12115,59,0,59,
920,11755,13555,80,0,80,
921,7280,9080,140,0,140,
922,10160,11960,0,0,0,
923,11600,13400,84,52,136,928:43&1636:9
924,11780,13580,93,0,93,
925,12075,12435,88,73,161,941:73
926,7520,9320,100,0,100,
927,8960,10760,122,0,122,
928,10400,12200,0,0,0,
929,11840,13640,64,0,64,
930,7315,9115,160,0,160,
931,7605,9405,161,0,161,
932,8900,10700,126,0,126,
933,7855,9655,150,0,150,
934,9305,11105,69,0,69,
935,10875,12545,109,52,161,864:7&1868:45
936,12185,13985,126,0,126,
937,10690,12490,104,0,104,
938,7810,9610,162,0,161,
939,12130,13930,50,0,50,
940,10890,12690,105,56,161,403:56
941,9195,10995,0,0,0,
942,7680,9480,92,0,92,
943,9120,10920,113,0,113,
944,10560,12360,71,0,71,
945,7800,9600,89,0,89,
946,9240,11040,41,0,41,
947,10735,12480,134,27,161,2361:27
948,12120,13615,102,59,161,2361:59
949,12000,13800,61,0,61,
950,8045,9845,162,0,161,
951,9485,11285,141,0,141,
952,10925,12725,128,0,128,
953,12365,14165,123,0,123,
954,7470,9270,111,0,111,
955,8910,10710,103,0,103,
956,10350,12150,0,0,0,
957,11790,13590,133,22,155,412:22
958,10745,12545,63,0,63,
959,7990,9790,163,0,161,
960,9430,11230,135,0,135,
961,10870,12670,133,0,133,
962,12310,14110,117,0,117,
963,11635,13435,59,0,59,
964,10930,12730,78,77,155,1637:77
965,11925,12285,86,18,104,915:6&982:12
966,7615,9415,141,0,141,
967,9055,10855,132,0,132,
968,10495,12295,71,0,71,
969,11935,13735,102,0,102,
970,8755,10555,73,0,73,
971,10195,11995,127,0,127,
972,7865,9665,101,0,101,
973,9305,11105,36,0,36,
974,12185,13985,46,0,46,
975,7460,9260,163,0,161,
976,10340,12140,146,0,146,
977,7755,9555,171,0,161,
978,10635,12435,143,18,161,941:18
979,8050,9850,171,0,161,
980,9490,11290,0,0,0,
981,12370,14170,46,0,46,
982,9045,10845,0,0,0,
983,10485,12285,149,12,161,915:12
984,7400,9920,124,0,124,
985,10280,12800,0,0,0,
986,8075,9875,121,0,121,
987,9515,11315,107,0,107,
988,10955,12755,43,0,43,
989,12395,14195,25,0,25,
990,11040,12840,52,0,52,
991,7715,10235,134,0,134,
992,10595,13115,103,0,103,
993,7925,9725,121,0,121,
994,9365,11165,0,0,0,
995,10805,12605,39,80,119,994:39&1005:41
996,12245,14045,51,0,51,
997,8160,9960,96,0,96,
998,12480,14280,35,0,35,
999,7580,9380,128,0,128,
1000,9020,10820,0,0,0,
1001,10460,12260,80,64,144,1000:64
1002,11900,13700,65,0,65,
1003,7510,9310,80,0,80,
1004,8950,10750,46,0,46,
1005,10390,12190,0,0,0,
1006,11830,13630,47,0,47,
1007,9600,11400,0,0,0,
1008,8085,9885,155,0,155,
1009,10965,12765,21,0,21,
1010,12405,14205,27,0,27,
1011,7260,9060,56,0,56,
1012,8700,10500,40,0,40,
1013,10140,11940,0,0,0,
1014,11580,13380,77,0,77,
1015,7660,10180,68,0,68,
1016,10540,12325,57,39,96,1393:39
1017,7670,9470,125,0,125,
1018,9110,10910,0,0,0,
1019,10550,12350,41,78,119,1145:7&1018:71
1020,11990,13790,33,0,33,
1021,8010,9810,148,0,148,
1022,12330,12690,52,9,61,1032:9
1023,7895,10415,106,0,106,
1024,10775,12570,64,97,161,110:67&1486:30
1025,7420,9220,79,0,79,
1026,11740,13540,61,0,61,
1027,7855,9655,140,0,140,
1028,9295,11095,76,0,76,
1029,10735,12535,49,0,49,
1030,12175,13975,26,0,26,
1031,9250,11050,75,0,75,
1032,9450,11250,0,0,0,
1033,10300,12100,0,0,0,
1034,7985,9785,106,0,106,
1035,9425,11225,0,0,0,
1036,10865,12665,60,47,107,1013:9&1035:38
1037,12305,14105,78,0,78,
1038,8860,10660,48,0,48,
1039,7835,9635,149,0,149,
1040,9275,11075,77,0,77,
1041,10715,12515,38,0,38,
1042,12155,13955,28,0,28,
1043,7555,9355,59,0,59,
1044,9000,10800,33,0,33,
1045,10435,12235,51,0,51,
1046,11880,13680,38,0,38,
1047,7485,9285,141,0,141,
1048,8925,10725,114,0,114,
1049,11805,12720,73,46,119,2320:12&915:34
1050,9130,10930,0,0,0,
1051,7320,9120,72,0,72,
1052,8760,10560,31,0,31,
1053,10200,12000,0,0,0,
1054,11640,13440,37,54,91,1005:54
1055,7745,9545,168,0,168,
1056,9185,10985,110,0,110,
1057,10625,12425,0,0,0,
1058,12065,13865,128,21,149,1057:21
1059,12220,12580,157,26,183,1062:26
1060,7670,10190,146,0,146,
1061,10470,12990,0,0,0,
1062,9340,11860,0,0,0,
1063,10590,12390,43,0,43,
1064,10735,12580,147,14,161,1062:14
1065,9075,11595,157,0,157,
1066,11955,13710,156,27,183,1061:27
1067,7940,9740,174,0,174,
1068,9380,11180,0,0,0,
1069,10820,12620,157,26,183,1068:26
1070,12260,12620,126,32,158,1068:32
1071,7955,10475,110,0,110,
1072,7710,9510,161,0,161,
1073,9150,10950,0,0,0,
1074,12030,13830,62,0,62,
1075,7285,9085,89,0,89,
1076,8725,10525,40,0,40,
1077,10165,11965,0,0,0,
1078,11605,13405,39,0,39,
1079,7495,9295,119,0,119,
1080,10375,12175,39,80,119,1095:33&1145:47
1081,11815,13615,51,0,51,
1082,8110,9910,176,0,176,
1083,9550,11350,69,0,69,
1084,10990,12790,166,17,183,1975:17
1085,12430,13620,167,16,183,1975:16
1086,7325,9125,117,0,117,
1087,8765,10565,74,0,74,
1088,11645,13445,78,41,119,864:41
1089,8935,10735,105,0,105,
1090,7690,9490,131,0,131,
1091,10570,12370,56,105,161,1154:11&1050:94
1092,12010,13810,65,0,65,
1093,7545,9345,151,0,151,
1094,8985,10785,0,0,0,
1095,9525,11325,0,0,0,
1096,10425,12225,74,87,161,1094:87
1097,11865,13665,157,0,157,
1098,8105,9905,132,0,132,
1099,9545,11345,0,0,0,
1100,10985,12360,93,90,183,1179:90
1101,12425,12785,103,12,115,1099:12
1102,7600,9400,125,0,125,
1103,10480,12280,62,0,62,
1104,11920,13720,60,0,60,
1105,12205,14005,31,0,31,
1106,7885,9685,161,0,161,
1107,7890,9690,115,0,115,
1108,9330,11130,0,0,0,
1109,10770,12570,44,43,87,1108:26&1077:17
1110,12210,14010,63,0,63,
1111,7720,9520,125,0,125,
1112,10600,12400,106,13,119,1125:13
1113,12040,12400,90,60,150,1125:60
1114,7295,9095,72,0,72,
1115,8735,10535,66,0,66,
1116,11615,13415,48,46,94,640:46
1117,9040,10840,43,0,43,
1118,7330,9130,92,0,92,
1119,8770,10570,55,0,55,
1120,10210,12010,0,0,0,
1121,11650,13450,45,56,101,1120:56
1122,8185,9985,67,0,67,
1123,11065,12370,48,59,107,1050:59
1124,12505,14305,15,0,15,
1125,9160,10960,0,0,0,
1126,7460,9260,95,0,95,
1127,8900,10700,100,0,100,
1128,11780,13580,106,0,106,
1129,7335,9135,127,0,127,
1130,8775,10575,147,0,147,
1131,10215,12015,0,0,0,
1132,11655,13455,132,44,176,1131:44
1133,10420,12220,123,0,123,
1134,7735,9535,111,0,111,
1135,9175,10975,53,0,53,
1136,10750,12415,87,74,161,1005:51&1053:23
1137,12055,13855,53,0,53,
1138,8980,10780,91,0,91,
1139,7540,9340,93,0,93,
1140,11860,13660,75,0,75,
1141,7470,9270,109,0,109,
1142,8910,10710,96,0,96,
1143,10350,12150,54,0,54,
1144,11790,13590,75,0,75,
1145,9325,11125,0,0,0,
1146,10765,12350,40,11,51,1018:11
1147,7930,9730,127,0,127,
1148,9370,11170,0,0,0,
1149,10810,12610,112,71,183,1148:71
1150,12250,13630,89,72,161,1164:72
1151,7790,9590,65,0,65,
1152,10670,12470,26,0,26,
1153,12110,13910,39,0,39,
1154,9625,11425,0,0,0,
1155,7535,9335,149,0,149,
1156,8975,10775,0,0,0,
1157,10415,12215,144,17,161,25:17
1158,11855,12215,116,41,157,1156:17&25:24
1159,9050,11570,146,0,146,
1160,10490,13010,0,0,0,
1161,11930,12520,112,71,183,1160:41&1373:30
1162,7510,9310,125,0,125,
1163,8950,10750,128,0,128,
1164,10390,12190,0,0,0,
1165,11830,12610,100,83,183,1148:53&1164:30
1166,7610,10130,159,0,159,
1167,7535,9335,160,0,160,
1168,8975,10775,108,0,108,
1169,10415,12215,71,0,71,
1170,11855,13655,30,0,30,
1171,7965,9765,161,0,161,
1172,10845,12390,35,84,119,1073:15&1033:18&1007:51
1173,12285,14085,19,0,19,
1174,7435,9235,161,0,161,
1175,8875,10675,93,0,93,
1176,10315,12115,48,0,48,
1177,11755,13555,41,0,41,
1178,7680,9480,163,0,163,
1179,9120,10920,0,0,0,
1180,10560,12360,118,43,161,1099:43
1181,12000,12360,114,69,183,1099:36&1179:33
1182,12260,12620,93,68,161,1185:68
1183,10750,12565,146,37,183,1191:37
1184,12205,12795,141,42,183,1346:42
1185,9380,11900,0,0,0,
1186,7655,9455,144,0,144,
1187,9095,10895,105,0,105,
1188,10535,12335,75,0,75,
1189,11975,13775,38,0,38,
1190,7885,10405,134,0,134,
1191,9325,11845,0,0,0,
1192,7295,9095,154,0,154,
1193,8735,10535,163,0,163,
1194,10175,11975,0,0,0,
1195,11615,13415,133,24,157,60:24
1196,9115,11635,130,0,130,
1197,11995,14515,130,0,130,
1198,7685,9485,139,0,139,
1199,9125,10925,90,0,90,
1200,10565,12365,62,0,62,
1201,12005,13805,26,0,26,
1202,9150,10950,73,0,73,
1203,12030,13830,21,0,21,
1204,7560,9360,113,0,113,
1205,9000,10800,126,0,126,
1206,10440,12240,0,0,0,
1207,11880,13445,73,32,105,1246:32
1208,10430,12230,0,0,0,
1209,11870,12460,73,88,161,1218:43&1208:45
1210,7750,10270,132,0,132,
1211,9190,11710,78,0,78,
1212,10630,13150,50,0,50,
1213,12070,14590,56,0,56,
1214,10205,12005,118,0,118,
1215,10335,12135,175,8,183,1859:8
1216,11645,13445,123,0,123,
1217,7780,9580,147,0,147,
1218,9220,11020,0,0,0,
1219,10660,12460,70,91,161,1218:91
1220,12100,13670,28,2,30,1208:2
1221,11775,12800,166,17,183,1859:17
1222,7325,9125,178,0,178,
1223,8765,10565,142,0,142,
1224,7690,10210,148,0,148,
1225,10570,13090,98,0,98,
1226,12010,14530,96,0,96,
1227,7680,9480,86,0,86,
1228,9120,10920,69,0,69,
1229,10580,12360,53,57,110,1276:57
1230,12000,13800,63,0,63,
1231,7455,9255,181,0,181,
1232,8895,10695,146,0,146,
1233,7920,10440,121,0,121,
1234,10800,13320,98,0,98,
1235,12240,14760,75,0,75,
1236,9130,11650,110,0,110,
1237,7400,9920,103,0,103,
1238,8840,11360,134,0,134,
1239,10280,12800,137,0,137,
1240,11720,14240,94,0,94,
1241,7250,9050,177,0,177,
1242,8690,10490,137,0,137,
1243,10130,11930,0,0,0,
1244,11570,13370,142,19,161,1243:19
1245,9360,11880,60,0,60,
1246,10205,12005,0,0,0,
1247,11645,13445,50,111,161,1206:91&1246:20
1248,10150,11950,0,0,0,
1249,9355,11155,0,0,0,
1250,12235,12595,62,7,69,1249:7
1251,10375,12175,87,0,87,
1252,7405,9205,158,0,158,
1253,8845,10645,164,0,164,
1254,10285,12085,116,0,116,
1255,11725,13525,115,0,115,
1256,10715,12080,112,71,183,666:71
1257,11720,13520,143,40,183,666:40
1258,9075,10875,0,0,0,
1259,8840,10640,128,0,128,
1260,10270,12790,108,0,108,
1261,10735,12535,76,85,161,1265:85
1262,12175,13635,88,69,157,1290:69
1263,7400,9200,116,0,116,
1264,7855,9655,92,0,92,
1265,9295,11095,0,0,0,
1266,7320,9120,123,0,123,
1267,8760,10560,85,0,85,
1268,10200,12000,0,0,0,
1269,11640,13440,94,0,94,
1270,7705,9505,144,0,144,
1271,9145,10945,44,0,44,
1272,10585,12385,46,0,46,
1273,12025,13825,44,0,44,
1274,7340,9140,83,0,83,
1275,8780,10580,58,0,58,
1276,10220,12020,0,0,0,
1277,11660,13460,129,0,129,
1278,7470,9270,161,0,161,
1279,8910,10710,99,0,99,
1280,10350,12150,66,0,66,
1281,11790,13590,89,0,89,
1282,7905,9705,146,0,146,
1283,9345,11145,0,0,0,
1284,10785,12300,107,76,183,2114:45&470:31
1285,12225,14025,82,0,82,
1286,10750,12550,58,0,58,
1287,7870,9670,76,0,76,
1288,9310,11110,0,0,0,
1289,12190,13990,15,0,15,
1290,10395,12195,0,0,0,
1291,7250,9050,161,0,161,
1292,8690,10490,161,0,161,
1293,10130,11930,0,0,0,
1294,11570,13370,154,29,183,1293:29
1295,7435,9235,104,0,104,
1296,8875,10675,0,0,0,
1297,10315,12115,0,0,0,
1298,11755,13555,52,0,52,
1299,7635,9435,103,0,103,
1300,10530,12315,74,87,161,192:3&1258:39&270:45
1301,11955,13755,42,0,42,
1302,7940,10460,130,0,130,
1303,8095,10615,143,0,143,
1304,8820,11340,167,0,161,
1305,11700,13500,98,63,161,1353:63
1306,8000,10520,107,0,107,
1307,9440,11960,0,0,0,
1308,10880,12680,96,59,155,567:18&1307:41
1309,12320,14840,78,0,78,
1310,7440,9960,88,0,88,
1311,8880,11400,117,0,117,
1312,10320,12840,0,0,0,
1313,11760,13560,70,113,183,1312:113
1314,9190,11710,116,0,116,
1315,12070,14590,108,0,108,
1316,7425,9945,148,0,148,
1317,8865,11385,124,0,124,
1318,10305,12825,79,0,79,
1319,11745,14265,123,0,123,
1320,7445,9965,106,0,106,
1321,8885,11405,106,0,106,
1322,10325,12845,0,0,0,
1323,11765,14285,68,0,68,
1324,7875,10395,119,0,119,
1325,10755,12555,92,69,161,1326:69
1326,9315,11835,0,0,0,
1327,12195,12555,87,35,122,1326:35
1328,7680,10200,82,0,82,
1329,9120,11640,29,0,29,
1330,10560,13080,0,0,0,
1331,12000,13800,21,12,33,1330:12
1332,7690,10210,161,0,161,
1333,10570,12530,104,57,161,851:6&855:51
1334,12005,14525,81,0,81,
1335,12235,14755,141,0,141,
1336,7900,10420,95,0,95,
1337,10780,12595,84,74,158,1340:74
1338,9125,11645,0,0,0,
1339,10920,13440,117,0,117,
1340,9355,11875,0,0,0,
1341,7820,10340,58,0,58,
1342,9260,11780,0,0,0,
1343,10700,12500,117,38,155,1342:38
1344,12140,12500,13,8,21,1342:8
1345,12325,14845,98,0,98,
1346,9555,12075,0,0,0,
1347,9350,11870,0,0,0,
1348,12230,14750,57,0,57,
1349,7320,9840,89,0,89,
1350,8820,11340,142,0,142,
1351,11700,14220,123,0,123,
1352,7380,9900,131,0,131,
1353,10260,12780,0,0,0,
1354,7995,10515,77,0,77,
1355,10875,12675,98,58,156,1371:58
1356,12315,14835,76,0,76,
1357,8815,11335,167,0,161,
1358,11695,12460,139,44,183,216:4&268:40
1359,7750,10270,96,0,96,
1360,10775,12215,79,82,161,848:19&849:25&159:38
1361,9135,11655,137,0,137,
1362,12015,14535,66,0,66,
1363,7615,10135,55,0,55,
1364,9055,11575,36,0,36,
1365,10495,13015,31,0,31,
1366,11935,14455,25,0,25,
1367,7795,10315,133,0,133,
1368,9235,11755,152,0,152,
1369,10675,13195,0,0,0,
1370,12115,13915,143,40,183,1369:40
1371,9435,11955,0,0,0,
1372,7730,10250,125,0,125,
1373,9280,11800,0,0,0,
1374,10610,12520,159,24,183,1373:24
1375,12160,13730,145,38,183,1160:38
1376,8760,11280,122,0,122,
1377,10200,12720,0,0,0,
1378,11640,13440,97,86,183,1377:86
1379,7815,10335,73,0,73,
1380,9255,11775,38,0,38,
1381,10695,13215,48,0,48,
1382,12135,14655,32,0,32,
1383,9465,11985,0,0,0,
1384,10905,12705,29,18,47,1383:18
1385,8025,10545,45,0,45,
1386,12345,14865,40,0,40,
1387,10895,12565,133,50,183,1346:7&1191:43
1388,8015,10535,101,0,101,
1389,12435,12795,115,20,135,1346:20
1390,8005,10525,127,0,127,
1391,9445,11965,142,0,142,
1392,10885,13405,138,0,138,
1393,9085,11605,0,0,0,
1394,11965,14485,51,0,51,
1395,9525,12045,0,0,0,
1396,10965,12765,156,27,183,1395:27
1397,10440,12960,153,0,153,
1398,8085,10605,160,0,160,
1399,12405,12765,146,15,161,1395:15
1400,7930,10450,157,0,157,
1401,9370,11890,0,0,0,
1402,10810,12610,107,54,161,1401:54
1403,12250,12610,141,20,161,1401:20
1404,7850,10370,110,0,110,
1405,9310,11830,0,0,0,
1406,10730,12550,104,79,183,1405:79
1407,12170,12550,139,15,154,1405:15
1408,7390,9910,92,0,92,
1409,7560,10080,100,0,100,
1410,8805,11325,94,0,94,
1411,11685,13485,87,1,88,1416:1
1412,9465,11985,0,0,0,
1413,10905,12705,161,22,183,1412:22
1414,12345,12705,143,18,161,1412:18
1415,7365,9885,77,0,77,
1416,10245,12765,84,0,84,
1417,6870,9390,147,0,147,
1418,8310,10830,159,0,159,
1419,11190,12990,151,10,161,1420:10
1420,9750,12270,0,0,0,
1421,8025,10545,137,0,137,
1422,8965,11485,145,0,145,
1423,10405,12925,156,0,156,
1424,11845,14365,161,0,161,
1425,7380,9900,132,0,132,
1426,10260,12780,131,0,131,
1427,7945,10465,150,0,150,
1428,10825,12625,147,36,183,1435:36
1429,12265,12625,156,5,161,1435:5
1430,7525,10045,136,0,136,
1431,7525,10045,150,0,150,
1432,8965,11485,161,0,161,
1433,10405,12925,161,0,161,
1434,11845,14365,161,0,161,
1435,9385,11905,0,0,0,
1436,10710,13230,128,0,128,
1437,7250,9050,60,0,60,
1438,8840,11360,146,0,146,
1439,10280,12800,0,0,0,
1440,7400,9920,140,0,140,
1441,11720,13520,145,16,161,1439:16
1442,7675,10195,124,0,124,
1443,10555,12355,108,53,161,1445:53
1444,11995,12355,121,40,161,1445:40
1445,9115,11635,0,0,0,
1446,10795,12595,108,75,183,825:75
1447,10225,12745,0,0,0,
1448,10540,13060,88,0,88,
1449,9100,11620,124,0,124,
1450,9310,11830,0,0,0,
1451,10750,12550,120,41,161,1450:41
1452,8835,11355,243,0,243,
1453,11715,14235,242,0,242,
1454,9835,12355,255,0,255,
1455,7900,10420,90,0,90,
1456,12220,14740,52,0,52,
1457,9340,11860,0,0,0,
1458,10780,12580,48,51,99,1457:51
1459,7740,10260,66,0,66,
1460,9180,11700,38,0,38,
1461,10620,13140,0,0,0,
1462,12060,13860,41,62,103,1461:62
1463,10250,12770,0,0,0,
1464,10480,13000,102,0,102,
1465,10815,13335,51,0,51,
1466,9130,11650,0,0,0,
1467,12010,12370,115,46,161,1466:46
1468,9395,11915,0,0,0,
1469,10555,13075,45,0,45,
1470,12275,12635,91,70,161,1468:70
1471,8800,11320,117,0,117,
1472,11680,13480,117,66,183,1473:66
1473,10240,12760,0,0,0,
1474,7360,9880,154,0,154,
1475,9230,11750,0,0,0,
1476,10670,12470,89,72,161,1475:72
1477,7325,9845,121,0,121,
1478,8765,11285,105,0,105,
1479,10205,12725,0,0,0,
1480,11645,12690,72,89,161,662:44&810:33&523:12
1481,8110,10630,121,0,121,
1482,9550,12070,0,0,0,
1483,10990,12790,99,62,161,1482:62
1484,12430,13550,56,13,69,815:13
1485,8915,11435,70,0,70,
1486,10355,12875,0,0,0,
1487,8150,10670,159,0,159,
1488,9590,12110,0,0,0,
1489,12470,14990,89,0,89,
1490,11030,12830,109,67,176,1488:67
1491,7530,10050,120,0,120,
1492,11850,14370,106,0,106,
1493,12075,14595,130,0,130,
1494,7755,10275,60,0,60,
1495,7685,10205,131,0,131,
1496,9125,11645,64,0,64,
1497,10565,13085,40,34,74,320:34
1498,12005,14525,58,0,58,
1499,7805,10325,129,0,129,
1500,9245,11765,0,0,0,
1501,10685,12485,128,55,183,311:34&1500:21
1502,12125,12485,65,96,161,1500:96
1503,8820,11340,115,0,115,
1504,9060,11580,0,0,0,
1505,10825,13345,100,0,100,
1506,7945,10465,125,0,125,
1507,8155,9955,99,0,99,
1508,11035,12835,144,0,144,
1509,7715,10235,141,0,141,
1510,10595,13115,0,0,0,
1511,8000,9800,119,0,119,
1512,10880,12680,72,0,72,
1513,10790,13310,58,0,58,
1514,7910,10430,59,0,59,
1515,7750,10270,49,0,49,
1516,10630,13150,36,0,36,
1517,8130,9930,183,0,183,
1518,9570,11370,141,0,141,
1519,11010,12810,106,0,106,
1520,12450,14250,108,0,108,
1521,7320,9120,138,0,138,
1522,8760,10560,130,0,130,
1523,10200,12000,97,0,97,
1524,11640,13440,88,0,88,
1525,7480,9280,171,0,171,
1526,8920,10720,132,0,132,
1527,10360,12160,107,0,107,
1528,11800,13600,88,0,88,
1529,7960,9760,161,0,161,
1530,9400,11200,120,0,120,
1531,10840,12640,112,0,112,
1532,12280,14080,71,0,71,
1533,7920,9720,154,0,154,
1534,10800,12600,102,0,102,
1535,7540,9340,117,0,117,
1536,10420,12220,0,0,0,
1537,11860,13445,107,25,132,346:25
1538,8120,9920,162,0,161,
1539,11000,12425,48,113,161,388:113
1540,12240,14040,98,0,98,
1541,12440,13865,77,30,107,361:30
1542,7740,9540,127,0,127,
1543,10620,12420,36,0,36,
1544,12060,13860,62,0,62,
1545,8925,10725,146,0,146,
1546,11805,13605,124,0,124,
1547,7335,9135,115,0,115,
1548,10215,12015,0,0,0,
1549,7485,9285,138,0,138,
1550,10365,12165,64,0,64,
1551,9405,11205,55,0,55,
1552,12285,14085,55,0,55,
1553,9560,11360,0,0,0,
1554,12440,12800,44,19,63,1553:19
1555,10845,12645,80,0,80,
1556,11000,12800,84,77,161,1553:77
1557,7965,9765,127,0,127,
1558,8775,10575,131,0,131,
1559,11655,13455,102,47,149,1548:47
1560,8120,9920,139,0,139,
1561,8150,9950,53,0,53,
1562,9590,11390,69,0,69,
1563,12470,14270,140,0,140,
1564,7235,9035,123,0,123,
1565,8665,10465,101,0,101,
1566,10105,11905,95,0,95,
1567,7315,9115,118,0,118,
1568,10195,11995,0,0,0,
1569,11635,13435,117,2,119,1568:2
1570,10355,12155,0,0,0,
1571,7475,9275,105,0,105,
1572,11795,13595,50,51,101,1570:51
1573,8125,9925,136,0,136,
1574,11005,12805,113,0,113,
1575,12445,14245,102,0,102,
1576,8165,9965,161,0,161,
1577,9605,11405,97,0,97,
1578,11045,12845,96,0,96,
1579,12485,14285,57,0,57,
1580,8155,9955,123,0,123,
1581,11035,12835,110,0,110,
1582,7295,9095,144,0,144,
1583,8735,10535,120,0,120,
1584,11615,13415,68,0,68,
1585,7475,9275,161,0,161,
1586,8915,10715,89,0,89,
1587,10355,12155,78,0,78,
1588,11795,13595,108,0,108,
1589,7495,9295,132,0,132,
1590,8935,10735,128,0,128,
1591,11815,13615,137,0,137,
1592,7985,9785,85,0,85,
1593,10865,12665,68,0,68,
1594,7270,9070,148,0,148,
1595,10500,11950,155,28,183,1600:28
1596,11590,13380,149,6,155,1600:6
1597,8710,10510,120,0,120,
1598,7260,9060,149,0,149,
1599,8700,10500,132,0,132,
1600,10140,11940,0,0,0,
1601,11580,13380,158,25,183,1600:25
1602,7830,9630,119,0,119,
1603,10775,12510,72,10,82,260:10
1604,12150,13950,45,0,45,
1605,7405,9205,75,0,75,
1606,8845,10645,129,0,129,
1607,10285,12085,0,0,0,
1608,11725,13525,108,45,153,1607:45
1609,8830,10630,140,0,140,
1610,10645,12070,156,27,183,1607:27
1611,11710,13510,114,69,183,1607:69
1612,7975,9775,77,0,77,
1613,10855,12425,47,67,114,225:19&250:48
1614,12295,14095,26,0,26,
1615,7390,9190,71,0,71,
1616,8770,10570,74,0,74,
1617,10210,12010,80,0,80,
1618,11650,13450,76,0,76,
1619,9400,11200,19,0,19,
1620,9540,11340,93,0,93,
1621,7330,9130,167,0,167,
1622,8010,9810,119,0,119,
1623,9450,11250,70,0,70,
1624,10890,12690,98,0,98,
1625,12330,14130,50,0,50,
1626,9010,10810,104,0,104,
1627,10450,12250,183,0,183,
1628,11890,13690,141,0,141,
1629,8790,10590,146,0,146,
1630,8950,10750,108,0,108,
1631,7570,9370,168,0,168,
1632,10910,12710,79,0,79,
1633,11065,12865,85,0,85,
1634,9470,11270,56,0,56,
1635,9155,10955,66,0,66,
1636,10595,12395,0,0,0,
1637,9625,11425,0,0,0,
1638,9325,11125,125,0,125,
1639,10765,12565,107,0,107,
1640,7805,9605,149,0,149,
1641,9245,11045,110,0,110,
1642,10685,12485,84,0,84,
1643,12125,13925,69,0,69,
1644,7880,9680,111,0,111,
1645,9320,11120,0,0,0,
1646,10760,12560,75,97,172,1645:97
1647,12200,14000,70,0,70,
1648,8110,9910,124,0,124,
1649,7750,9550,134,0,134,
1650,9190,10990,0,0,0,
1651,10630,12430,74,87,161,77:87
1652,12070,12430,95,26,121,1650:2&2269:19&77:5
1653,7850,9650,182,0,182,
1654,9290,11090,122,0,122,
1655,10730,12530,129,0,129,
1656,12170,13970,88,0,88,
1657,7690,9490,160,0,160,
1658,9130,10930,127,0,127,
1659,10570,12370,97,0,97,
1660,12010,13810,96,0,96,
1661,7695,9495,122,0,122,
1662,9135,10935,130,0,130,
1663,10575,12375,78,0,78,
1664,12015,13815,86,0,86,
1665,8020,9820,146,0,146,
1666,9460,11260,55,0,55,
1667,10900,12700,58,0,58,
1668,12340,14140,30,0,30,
1669,7965,9765,108,0,108,
1670,10845,12225,91,92,183,113:52&98:40
1671,12285,14085,124,0,124,
1672,8180,9980,126,0,126,
1673,9620,11420,118,0,118,
1674,11060,12860,78,0,78,
1675,12500,14300,49,0,49,
1676,9405,11205,0,0,0,
1677,9550,11350,0,0,0,
1678,12430,12790,106,30,136,1677:30
1679,10990,12790,109,74,183,1677:74
1680,7310,9110,177,0,177,
1681,7750,9550,161,0,161,
1682,12070,13420,78,83,161,1750:83
1683,10190,11990,64,0,64,
1684,7505,9305,183,0,183,
1685,10385,12185,93,0,93,
1686,7805,9605,139,0,139,
1687,9245,11045,139,0,139,
1688,10685,12485,98,0,98,
1689,12125,13925,85,0,85,
1690,7930,9730,156,0,156,
1691,12250,14050,90,0,90,
1692,8745,10545,133,0,133,
1693,10185,11985,81,0,81,
1694,11625,13425,77,0,77,
1695,7660,9460,177,0,177,
1696,10540,12340,120,0,120,
1697,7995,9795,116,0,116,
1698,9435,11235,46,0,46,
1699,10875,12675,54,0,54,
1700,7815,9615,173,0,173,
1701,10695,12495,141,0,141,
1702,7880,9680,138,0,138,
1703,9320,11120,89,0,89,
1704,10760,12560,90,0,90,
1705,12200,14000,55,0,55,
1706,9100,10900,117,0,117,
1707,11980,13780,110,0,110,
1708,8190,9990,170,0,161,
1709,9630,11430,72,0,72,
1710,11070,12870,49,0,49,
1711,8965,10765,128,0,128,
1712,10405,12205,122,0,122,
1713,11845,13645,93,0,93,
1714,8750,10550,147,0,147,
1715,11630,13430,98,0,98,
1716,12315,14115,28,0,28,
1717,9255,11055,164,0,164,
1718,12135,13935,155,0,155,
1719,12510,14310,17,0,17,
1720,8945,10745,148,0,148,
1721,11825,13625,98,0,98,
1722,7640,9440,114,0,114,
1723,9080,10880,89,0,89,
1724,10520,12320,69,0,69,
1725,11960,13760,56,0,56,
1726,12285,14085,81,0,81,
1727,8070,9870,118,0,118,
1728,9510,11310,76,0,76,
1729,10950,12750,82,0,82,
1730,12390,14190,40,0,40,
1731,12445,12805,72,47,119,124:28&2268:19
1732,8965,10765,36,0,36,
1733,11845,13645,29,0,29,
1734,7965,9765,113,0,113,
1735,8755,10555,82,0,82,
1736,11635,13435,59,0,59,
1737,7365,9165,128,0,128,
1738,8805,10605,120,0,120,
1739,10245,12045,103,0,103,
1740,11685,13485,58,0,58,
1741,7315,9115,120,0,119,
1742,8125,9925,107,0,107,
1743,8740,10540,133,0,133,
1744,7985,9785,153,0,153,
1745,9425,11225,140,0,140,
1746,10865,12665,126,0,126,
1747,12305,14105,92,0,92,
1748,7625,9425,102,0,102,
1749,11945,13395,32,87,119,678:13&44:74
1750,10180,11980,0,0,0,
1751,7790,9590,113,0,113,
1752,12110,13910,68,0,68,
1753,7335,9135,165,0,165,
1754,8775,10575,145,0,145,
1755,10215,12015,150,0,150,
1756,11655,13455,124,0,124,
1757,8930,10730,90,0,90,
1758,10370,12170,94,0,94,
1759,7905,9705,105,0,105,
1760,12225,14025,77,0,77,
1761,7455,9255,125,0,125,
1762,8895,10695,121,0,121,
1763,10335,12135,60,0,60,
1764,11775,13575,79,0,79,
1765,9065,10865,44,0,44,
1766,10505,12305,131,0,131,
1767,11945,13745,61,0,61,
1768,12430,14230,34,0,34,
1769,7525,9325,70,0,70,
1770,7690,9490,29,0,29,
1771,10570,12370,103,0,103,
1772,9210,11010,0,0,0,
1773,10650,12450,87,96,183,2270:96
1774,12090,13890,115,0,115,
1775,7835,9635,103,0,103,
1776,10715,12515,88,0,88,
1777,7625,9425,146,0,146,
1778,7770,9570,158,0,158,
1779,7305,9105,159,0,159,
1780,8745,10545,141,0,141,
1781,10185,11985,0,0,0,
1782,11625,13425,105,56,161,2297:56
1783,8110,9910,106,0,106,
1784,8010,9810,130,0,130,
1785,9450,11250,0,0,0,
1786,10890,12690,76,0,76,
1787,12330,14130,43,0,43,
1788,9310,11110,77,0,77,
1789,9490,11290,0,0,0,
1790,7870,9670,166,0,161,
1791,12190,13990,114,0,114,
1792,9600,11400,0,0,0,
1793,11040,12435,97,30,127,1822:30
1794,8050,9850,128,0,128,
1795,12370,12730,131,50,181,1789:50
1796,10750,12550,100,0,100,
1797,8160,9960,152,0,152,
1798,12480,14280,39,0,39,
1799,10930,12730,120,41,161,1789:41
1800,7470,9270,148,0,148,
1801,8910,10710,148,0,148,
1802,10350,12150,0,0,0,
1803,11790,13590,91,58,149,1802:58
1804,7630,9430,155,0,155,
1805,9070,10870,128,0,128,
1806,10510,12310,56,0,56,
1807,11950,13750,122,0,122,
1808,7380,9180,67,0,67,
1809,8820,10620,85,0,85,
1810,10260,12060,0,0,0,
1811,7590,9390,151,0,151,
1812,9030,10830,99,0,99,
1813,10470,12270,52,63,115,1785:63
1814,11910,13710,44,0,44,
1815,11695,13495,99,84,183,1810:84
1816,7560,9360,99,0,99,
1817,10440,12240,0,0,0,
1818,11880,13680,115,68,183,1817:68
1819,7755,9555,138,0,138,
1820,12075,13875,70,0,70,
1821,9000,10800,0,0,0,
1822,9195,10995,0,0,0,
1823,10635,12435,72,111,183,1792:55&1822:56
1824,7945,9745,102,0,102,
1825,9645,11445,0,0,0,
1826,8050,9850,121,0,121,
1827,8205,10005,109,0,109,
1828,7750,9550,165,0,161,
1829,9190,10990,138,0,138,
1830,10630,12430,0,0,0,
1831,10685,12485,60,0,60,
1832,10825,12235,75,44,119,101:44
1833,7865,9665,148,0,148,
1834,9305,11105,133,0,133,
1835,10745,12545,79,0,79,
1836,9485,11285,0,0,0,
1837,10925,12725,90,93,183,1836:93
1838,11785,13490,56,63,119,88:63
1839,8045,9845,153,0,153,
1840,12365,12725,72,3,75,1836:3
1841,11980,13780,43,0,43,
1842,9535,11335,0,0,0,
1843,10930,12730,85,0,85,
1844,8905,10705,82,0,82,
1845,9100,10900,118,0,118,
1846,10975,12775,116,45,161,1842:45
1847,11085,12885,106,0,106,
1848,7805,9605,100,0,100,
1849,8095,9895,144,0,144,
1850,12415,12775,78,53,131,1842:53
1851,9490,11290,48,0,48,
1852,7970,9770,142,0,142,
1853,9410,11210,128,0,128,
1854,10850,12650,125,58,183,1243:58
1855,12290,13370,143,9,152,1243:9
1856,8120,9920,155,0,155,
1857,11000,12800,149,34,183,1859:34
1858,12440,12800,117,66,183,1859:66
1859,9560,11360,0,0,0,
1860,8105,9905,154,0,154,
1861,10985,12785,109,0,109,
1862,7905,9705,146,0,146,
1863,9345,11145,89,0,89,
1864,10785,12585,93,0,93,
1865,12225,14025,59,0,59,
1866,7635,9435,147,0,147,
1867,9075,10875,94,0,94,
1868,10515,12315,0,0,0,
1869,7795,9595,170,0,170,
1870,9235,11035,131,0,131,
1871,10675,12475,95,0,95,
1872,8055,9855,141,0,141,
1873,12375,14175,54,0,54,
1874,7555,9355,161,0,161,
1875,8995,10795,154,0,154,
1876,10435,12235,90,0,90,
1877,11875,13675,54,0,54,
1878,7390,9190,119,0,119,
1879,8830,10630,51,0,51,
1880,10270,12070,73,0,73,
1881,11710,13510,87,0,87,
1882,7255,9055,177,0,177,
1883,8695,10495,156,0,156,
1884,10135,11935,114,0,114,
1885,11575,13375,86,0,86,
1886,7900,9700,154,0,154,
1887,7340,9140,144,0,144,
1888,8780,10580,111,0,111,
1889,10220,12020,67,0,67,
1890,11660,13460,68,0,68,
1891,9340,11140,82,0,82,
1892,10780,12580,43,0,43,
1893,12220,14020,48,0,48,
1894,8065,9865,155,0,155,
1895,9505,11305,150,0,150,
1896,10945,12745,131,0,131,
1897,12385,14185,135,0,135,
1898,9035,10835,38,0,38,
1899,10475,12275,95,0,95,
1900,11915,13715,59,0,59,
1901,7595,9395,146,0,146,
1902,7410,9210,98,0,98,
1903,8850,10650,69,0,69,
1904,10290,12090,0,0,0,
1905,11730,13530,34,35,69,1904:35
1906,9495,11295,124,0,124,
1907,10935,12735,71,0,71,
1908,8040,9840,177,0,177,
1909,10920,12720,125,0,125,
1910,12360,14160,106,0,106,
1911,7825,9625,161,0,161,
1912,10705,12505,151,0,151,
1913,12145,13945,87,0,87,
1914,7890,9690,128,0,128,
1915,9330,11130,91,0,91,
1916,10770,12570,133,0,133,
1917,12210,14010,115,0,115,
1918,7400,9200,145,0,145,
1919,10280,12080,95,0,95,
1920,7550,9350,173,0,173,
1921,10430,12230,96,0,96,
1922,7775,9575,181,0,181,
1923,9215,11015,134,0,134,
1924,10655,12455,126,0,126,
1925,12095,13895,87,0,87,
1926,7575,9375,157,0,157,
1927,9015,10815,132,0,132,
1928,10455,12255,133,0,133,
1929,11895,13695,110,0,110,
1930,8840,10640,115,0,115,
1931,11720,13520,95,0,95,
1932,8990,10790,137,0,137,
1933,11870,13670,135,0,135,
1934,7280,9080,144,0,144,
1935,10160,11960,144,0,144,
1936,11600,13400,101,0,101,
1937,7650,9450,147,0,147,
1938,9090,10890,135,0,135,
1939,10530,12330,128,0,128,
1940,11970,13770,81,0,81,
1941,7655,9455,145,0,145,
1942,9095,10895,109,0,109,
1943,10535,12335,115,0,115,
1944,11975,13775,113,0,113,
1945,7595,9395,103,0,103,
1946,10475,12275,102,0,102,
1947,11915,13715,82,0,82,
1948,7860,9660,148,0,148,
1949,9300,11100,117,0,117,
1950,10740,12540,123,0,123,
1951,12180,13980,78,0,78,
1952,7465,9265,136,0,136,
1953,8905,10705,139,0,139,
1954,10345,12145,157,0,157,
1955,11785,13585,124,0,124,
1956,7605,9405,173,0,173,
1957,9045,10845,150,0,150,
1958,10485,12285,132,0,132,
1959,11925,13725,92,0,92,
1960,10750,12550,89,0,89,
1961,10920,12225,122,29,151,1094:29
1962,7615,9415,146,0,146,
1963,9055,10855,132,0,132,
1964,10495,12295,112,0,112,
1965,11935,13735,116,0,116,
1966,7870,9670,160,0,160,
1967,12190,13990,69,0,69,
1968,7775,9575,165,0,161,
1969,9215,11015,137,0,137,
1970,10655,12455,132,0,132,
1971,12095,13895,116,0,116,
1972,7500,9300,124,0,124,
1973,8040,9840,162,0,161,
1974,12360,14160,88,0,88,
1975,10380,12180,0,0,0,
1976,11820,13620,160,23,183,1975:23
1977,7315,9115,153,0,153,
1978,8755,10555,153,0,153,
1979,10195,11995,130,0,130,
1980,11635,13435,138,0,138,
1981,7375,9175,154,0,154,
1982,8815,10615,150,0,150,
1983,10255,12055,134,0,134,
1984,11695,13495,131,0,131,
1985,7720,9520,159,0,159,
1986,10600,12400,109,0,109,
1987,12040,13840,63,0,63,
1988,8045,9845,175,0,175,
1989,9485,11285,157,0,157,
1990,10925,12725,160,0,160,
1991,12365,14165,91,0,91,
1992,7885,9685,178,0,178,
1993,9325,11125,131,0,131,
1994,10765,12565,127,0,127,
1995,12205,14005,69,0,69,
1996,7415,9215,177,0,177,
1997,8855,10655,177,0,177,
1998,10295,12095,142,0,142,
1999,11735,13535,98,0,98,
2000,8135,9935,164,0,164,
2001,9575,11375,105,0,105,
2002,11015,12815,145,0,145,
2003,12455,14255,68,0,68,
2004,7830,9630,184,0,183,
2005,9270,11070,163,0,163,
2006,10710,12510,153,0,153,
2007,12150,13950,113,0,113,
2008,7235,9035,176,0,176,
2009,8675,10475,158,0,158,
2010,10115,11915,130,0,130,
2011,11555,13355,123,0,123,
2012,10465,12265,0,0,0,
2013,11905,13705,107,54,161,2012:54
2014,12085,13885,37,0,37,
2015,10585,12385,148,0,148,
2016,12025,13825,126,0,126,
2017,12270,14070,80,0,80,
2018,10835,12435,158,3,161,941:3
2019,12275,12635,101,60,161,2025:60
2020,10645,12445,115,0,115,
2021,7705,9505,173,0,173,
2022,7955,9755,179,0,179,
2023,9145,10945,42,0,42,
2024,10830,12630,110,0,110,
2025,9395,11195,0,0,0,
2026,7320,9120,130,0,130,
2027,8760,10560,133,0,133,
2028,10200,12000,0,0,0,
2029,11640,13440,168,15,183,2361:15
2030,10300,12100,0,0,0,
2031,11740,13540,62,51,113,2030:51
2032,7505,9305,177,0,177,
2033,8945,10745,168,0,168,
2034,10385,12185,71,0,71,
2035,11825,13625,120,0,120,
2036,7670,9470,158,0,158,
2037,10550,12350,133,0,133,
2038,11990,13790,119,0,119,
2039,7870,9670,111,0,111,
2040,10750,12520,54,41,95,2349:41
2041,12160,13960,119,0,119,
2042,11585,13385,113,48,161,2045:48
2043,11810,13610,130,0,130,
2044,7265,9065,114,0,114,
2045,10145,11945,0,0,0,
2046,7490,9290,159,0,159,
2047,10370,12155,91,2,93,2347:2
2048,7665,9465,150,0,150,
2049,9105,10905,154,0,154,
2050,10545,12345,157,0,157,
2051,11985,13785,142,0,142,
2052,7845,9645,181,0,181,
2053,9285,11085,146,0,146,
2054,10725,12525,145,0,145,
2055,12165,13965,128,0,128,
2056,7565,9365,169,0,169,
2057,9005,10805,156,0,156,
2058,10445,12245,124,0,124,
2059,11885,13685,117,0,117,
2060,7725,9525,149,0,149,
2061,9165,10965,164,0,164,
2062,10605,12405,148,0,148,
2063,12045,13845,118,0,118,
2064,7880,9680,132,0,132,
2065,8065,9865,111,0,111,
2066,8915,10715,102,0,102,
2067,10355,12155,91,9,100,2096:9
2068,11795,13595,116,0,116,
2069,10105,11905,91,55,146,564:55
2070,7225,9025,130,0,130,
2071,9440,11240,104,0,104,
2072,10880,12680,125,36,161,2085:36
2073,9605,11405,137,0,137,
2074,11045,12845,119,0,119,
2075,8000,9800,113,0,113,
2076,8165,9965,147,0,147,
2077,11010,12810,112,13,125,2081:13
2078,8735,10535,159,0,159,
2079,10175,11975,94,0,94,
2080,11615,13415,114,0,114,
2081,9610,11410,0,0,0,
2082,11545,13345,101,0,101,
2083,7270,9070,102,0,102,
2084,8710,10510,61,0,61,
2085,10150,11950,0,0,0,
2086,11590,13390,87,31,118,2085:31
2087,7425,9225,116,0,116,
2088,8865,10665,118,0,118,
2089,10305,12105,115,0,115,
2090,11745,13545,111,0,111,
2091,7575,9375,117,0,117,
2092,9015,10815,114,0,114,
2093,10455,12255,140,0,140,
2094,11895,13695,112,0,112,
2095,7725,9525,156,0,156,
2096,9165,10965,0,0,0,
2097,10605,12405,111,50,161,2096:50
2098,12045,13845,93,0,93,
2099,7485,9285,124,0,124,
2100,8925,10725,110,0,110,
2101,10365,12165,95,0,95,
2102,11805,13605,127,0,127,
2103,9050,10850,143,0,143,
2104,7645,9445,159,0,159,
2105,9085,10885,96,0,96,
2106,10525,12325,138,0,138,
2107,11965,13765,125,0,125,
2108,9215,11015,120,0,120,
2109,7805,9605,87,0,87,
2110,9245,11045,0,0,0,
2111,10685,12485,128,33,161,376:33
2112,12125,13925,57,0,57,
2113,9375,11175,62,0,62,
2114,9550,11350,0,0,0,
2115,7290,9090,91,0,91,
2116,8730,10530,48,0,48,
2117,10170,11970,0,0,0,
2118,11610,13410,126,35,161,336:35
2119,7245,9045,164,0,164,
2120,8685,10485,86,0,86,
2121,10125,11925,30,0,30,
2122,11565,13365,45,0,45,
2123,7430,9230,126,0,126,
2124,8870,10670,107,0,107,
2125,10310,12110,75,0,75,
2126,11750,13550,55,0,55,
2127,10990,12790,90,31,121,704:31
2128,7915,9715,115,0,115,
2129,10795,12595,124,0,124,
2130,8110,9910,150,0,150,
2131,9550,11350,108,0,108,
2132,12430,14230,57,0,57,
2133,7600,9400,122,0,122,
2134,9040,10840,120,0,120,
2135,10480,12280,103,0,103,
2136,11920,13720,76,0,76,
2137,9370,11170,120,0,120,
2138,12250,14050,74,0,74,
2139,8160,9960,126,0,126,
2140,9600,11400,113,0,113,
2141,11040,12840,92,0,92,
2142,12480,14280,71,0,71,
2143,7275,9075,133,0,133,
2144,8715,10515,122,0,122,
2145,10155,11955,40,0,40,
2146,11595,13395,85,0,85,
2147,7515,9315,142,0,142,
2148,8955,10755,143,0,143,
2149,11835,13635,107,0,107,
2150,7785,9585,170,0,161,
2151,9225,11025,135,0,135,
2152,10665,12465,106,0,106,
2153,12105,13905,74,0,74,
2154,7330,9130,140,0,140,
2155,8770,10570,115,0,115,
2156,11650,13450,111,0,111,
2157,7810,9610,97,0,97,
2158,10690,12490,0,0,0,
2159,11945,13730,52,25,77,2186:25
2160,8070,9870,120,0,120,
2161,12390,14190,60,0,60,
2162,12130,13930,51,20,71,2158:20
2163,10835,12635,96,0,96,
2164,10950,12750,87,0,87,
2165,7805,9605,156,0,156,
2166,9245,11045,129,0,129,
2167,10685,12485,118,0,118,
2168,12125,13925,102,0,102,
2169,7955,9755,106,0,106,
2170,12275,14075,57,0,57,
2171,7900,9700,152,0,152,
2172,10780,12580,60,0,60,
2173,7480,9280,163,0,163,
2174,8920,10720,137,0,137,
2175,10360,12160,106,0,106,
2176,11800,13600,134,0,134,
2177,8110,9910,176,0,176,
2178,9550,11350,143,0,143,
2179,10990,12790,125,0,125,
2180,12430,14230,95,0,95,
2181,7295,9095,123,0,123,
2182,8735,10535,156,0,156,
2183,10175,11975,100,0,100,
2184,11615,13415,105,0,105,
2185,7610,9410,88,0,88,
2186,10490,12290,0,0,0,
2187,7345,9145,161,0,161,
2188,8785,10585,107,0,107,
2189,10225,12025,102,0,102,
2190,11665,13465,92,0,92,
2191,7560,9360,111,0,111,
2192,9000,10800,108,0,108,
2193,10440,12240,100,0,100,
2194,11880,13680,76,0,76,
2195,7310,9110,131,0,131,
2196,8750,10550,102,0,102,
2197,11630,13430,68,0,68,
2198,9280,11080,0,0,0,
2199,10720,12520,159,2,161,2198:2
2200,12160,12520,75,45,120,2198:45
2201,7650,9450,152,0,152,
2202,9090,10890,137,0,137,
2203,10530,12330,82,0,82,
2204,11970,13770,93,0,93,
2205,7840,9640,41,0,41,
2206,7470,9270,175,0,175,
2207,8910,10710,151,0,151,
2208,10350,12150,138,0,138,
2209,11790,13590,95,0,95,
2210,9330,11130,124,0,124,
2211,10770,12570,143,0,143,
2212,9565,11365,135,0,135,
2213,11005,12805,153,0,153,
2214,9140,10940,68,0,68,
2215,10580,12380,0,0,0,
2216,12020,13820,42,48,90,2215:48
2217,7515,9315,118,0,118,
2218,10395,12195,77,0,77,
2219,11835,13635,64,0,64,
2220,7890,9690,132,0,132,
2221,12210,14010,136,0,136,
2222,8125,9925,144,0,144,
2223,12445,14245,126,0,126,
2224,7700,9500,155,0,155,
2225,8130,9930,106,0,106,
2226,7275,9075,154,0,154,
2227,8715,10515,104,0,104,
2228,10155,11955,78,0,78,
2229,11595,13395,101,0,101,
2230,7540,9340,125,0,125,
2231,10420,12220,96,0,96,
2232,11860,13660,91,0,91,
2233,8980,10780,82,0,82,
2234,7950,9750,88,0,88,
2235,10830,12630,56,0,56,
2236,11010,12810,102,0,102,
2237,7265,9065,132,0,132,
2238,10145,11945,111,0,111,
2239,11585,13385,121,0,121,
2240,7465,9265,133,0,133,
2241,8905,10705,100,0,100,
2242,10345,12145,82,0,82,
2243,11785,13585,113,0,113,
2244,7265,9065,161,0,161,
2245,8705,10505,88,0,88,
2246,10145,11945,50,0,50,
2247,11585,13385,108,0,108,
2248,7810,9610,116,0,116,
2249,10690,12490,116,0,116,
2250,12130,13930,71,0,71,
2251,10405,12205,42,0,42,
2252,12325,14125,17,0,17,
2253,9130,10930,30,0,30,
2254,12010,13810,73,0,73,
2255,9250,11050,100,0,100,
2256,9445,11245,87,0,87,
2257,8030,9830,140,0,140,
2258,10910,12710,99,0,99,
2259,9275,11075,0,0,0,
2260,12155,13955,38,0,38,
2261,10330,12130,67,0,67,
2262,9060,10860,116,0,116,
2263,10500,12300,49,0,49,
2264,9215,11015,110,0,110,
2265,7450,9250,103,0,103,
2266,7620,9420,99,0,99,
2267,9395,11195,91,0,91,
2268,9565,11365,0,0,0,
2269,10185,11985,0,0,0,
2270,9615,11415,0,0,0,
2271,11055,12450,63,85,148,1772:72&2270:13
2272,7485,9285,145,0,145,
2273,8925,10725,122,0,122,
2274,10365,12165,101,0,101,
2275,11805,13605,118,0,118,
2276,7330,9130,123,0,123,
2277,8770,10570,143,0,143,
2278,10210,12010,0,0,0,
2279,11650,13450,96,65,161,2278:65
2280,12335,14135,63,0,63,
2281,12505,14305,89,0,89,
2282,9455,11255,99,0,99,
2283,10895,12695,115,0,115,
2284,7705,9505,137,0,137,
2285,9145,10945,49,0,49,
2286,12025,13825,44,0,44,
2287,9625,11425,0,0,0,
2288,11065,12865,86,64,150,2287:64
2289,9240,11040,122,0,122,
2290,10680,12480,97,0,97,
2291,7865,9665,148,0,148,
2292,9305,11105,0,0,0,
2293,12185,12545,107,54,161,2292:54
2294,8015,9815,166,0,161,
2295,8185,9985,123,0,123,
2296,9085,10885,110,0,110,
2297,10525,12325,0,0,0,
2298,9430,11230,122,0,122,
2299,10870,12670,123,0,123,
2300,9530,11330,0,0,0,
2301,9365,11165,0,0,0,
2302,12245,12605,82,67,149,2301:67
2303,12410,12770,36,36,72,2300:36
2304,7855,9655,147,0,147,
2305,10735,12535,116,0,116,
2306,12175,13975,78,0,78,
2307,7990,9790,165,0,161,
2308,10870,12670,62,0,62,
2309,12310,14110,66,0,66,
2310,8135,9935,164,0,161,
2311,11015,12815,114,0,114,
2312,12455,14255,82,0,82,
2313,7980,9780,183,0,183,
2314,9420,11220,84,0,84,
2315,10860,12660,102,0,102,
2316,7655,9455,127,0,127,
2317,10535,12335,94,0,94,
2318,11975,13775,58,0,58,
2319,8170,9970,164,0,164,
2320,9610,11410,0,0,0,
2321,11050,12285,121,40,161,982:40
2322,8185,9985,93,0,93,
2323,10755,12555,120,0,120,
2324,7385,9185,109,0,109,
2325,8825,10625,140,0,140,
2326,10265,12065,0,0,0,
2327,11705,13505,73,88,161,608:88
2328,11065,12520,94,67,161,756:67
2329,12195,13995,68,0,68,
2330,12505,14305,74,0,74,
2331,7530,9330,163,0,161,
2332,8970,10770,152,0,152,
2333,10410,12210,102,0,102,
2334,11850,13650,126,0,126,
2335,9315,11115,116,0,116,
2336,9625,11425,0,0,0,
2337,7875,9675,161,0,161,
2338,8100,10620,63,0,63,
2339,9540,12060,0,0,0,
2340,10980,12590,66,76,142,805:76
2341,12420,14940,39,0,39,
2342,7230,9750,114,0,114,
2343,8670,11190,139,0,139,
2344,10110,12630,127,28,155,763:28
2345,11550,12800,108,51,159,763:51
2346,8710,10510,116,0,116,
2347,8915,10715,157,0,155,
2348,9110,10910,84,0,84,
2349,9280,11080,0,0,0,
2350,10740,12540,95,0,95,
2351,10915,12715,63,0,63,
2352,11700,13500,0,0,0,
2353,11970,13770,0,0,0,
2354,11730,13530,0,0,0,
2355,11970,13770,0,0,0,
2356,11620,13420,0,0,0,
2357,11600,13400,0,0,0,
2358,12240,14040,0,0,0,
2359,8935,10735,77,0,77,
2360,7495,9295,93,0,93,
2361,10375,12175,0,0,0,
2362,7330,9130,133,0,133,
2363,8770,10570,161,0,161,
2364,10210,12010,161,22,183,941:22
